project;test file;mutants;killed_output;killed_timeout;total_killed;survived;mutation score
linked-list1;test_3-5_1-0_326;44;35;6;41;3;93.18
linked-list1;test_3-5_0-0_10;44;25;8;33;11;75.00
linked-list1;test_3-5_0-4_137;44;25;5;30;14;68.18
linked-list1;test_3-5_0-1_56;44;25;8;33;11;75.00
linked-list1;test_3-5_1-0_310;44;36;5;41;3;93.18
linked-list1;test_3-5_0-7_226;44;25;8;33;11;75.00
linked-list1;test_3-5_0-2_78;44;25;8;33;11;75.00
linked-list1;test_3-5_0-8_262;44;25;11;36;8;81.82
linked-list1;test_3-5_0-9_283;44;25;8;33;11;75.00
linked-list1;test_3-5_0-0_4;44;25;8;33;11;75.00
linked-list1;test_3-5_0-6_200;44;8;0;8;36;18.18
linked-list1;test_3-5_0-1_50;44;25;8;33;11;75.00
linked-list1;test_3-5_0-6_183;44;25;8;33;11;75.00
linked-list1;test_3-5_0-5_177;44;28;5;33;11;75.00
linked-list1;test_3-5_0-6_210;44;25;8;33;11;75.00
linked-list1;test_3-5_0-5_180;44;25;8;33;11;75.00
linked-list1;test_3-5_0-3_116;44;25;8;33;11;75.00
linked-list1;test_3-5_0-2_70;44;25;8;33;11;75.00
linked-list1;test_3-5_0-4_133;44;25;8;33;11;75.00
linked-list1;test_3-5_1-0_322;44;25;8;33;11;75.00
linked-list1;test_3-5_0-9_273;44;25;8;33;11;75.00
linked-list1;test_3-5_1-0_328;44;25;8;33;11;75.00
linked-list1;test_3-5_0-8_248;44;25;8;33;11;75.00
linked-list1;test_3-5_0-3_95;44;25;8;33;11;75.00
linked-list1;test_3-5_1-0_301;44;28;5;33;11;75.00
linked-list1;test_3-5_0-8_268;44;25;8;33;11;75.00
linked-list1;test_3-5_0-3_114;44;25;8;33;11;75.00
linked-list1;test_3-5_0-7_220;44;25;5;30;14;68.18
linked-list1;test_3-5_0-0_5;44;25;8;33;11;75.00
linked-list1;test_3-5_0-3_91;44;25;8;33;11;75.00
linked-list1;test_3-5_0-2_90;44;25;8;33;11;75.00
linked-list1;test_3-5_0-6_185;44;25;5;30;14;68.18
linked-list1;test_3-5_0-7_225;44;25;8;33;11;75.00
linked-list1;test_3-5_1-0_314;44;17;1;18;26;40.91
linked-list1;test_3-5_0-1_45;44;25;8;33;11;75.00
linked-list1;test_3-5_0-9_293;44;25;8;33;11;75.00
linked-list1;test_3-5_0-2_77;44;25;8;33;11;75.00
linked-list1;test_3-5_0-0_17;44;25;8;33;11;75.00
linked-list1;test_3-5_1-0_312;44;31;9;40;4;90.91
linked-list1;test_3-5_0-4_121;44;25;9;34;10;77.27
linked-list1;test_3-5_0-6_203;44;28;5;33;11;75.00
linked-list1;test_3-5_0-6_181;44;25;8;33;11;75.00
linked-list1;test_3-5_0-7_222;44;25;8;33;11;75.00
linked-list1;test_3-5_0-9_294;44;28;4;32;12;72.73
linked-list1;test_3-5_1-0_308;44;25;8;33;11;75.00
linked-list1;test_3-5_0-1_46;44;25;8;33;11;75.00
linked-list1;test_3-5_0-6_196;44;25;11;36;8;81.82
linked-list1;test_3-5_0-5_172;44;25;5;30;14;68.18
linked-list1;test_3-5_0-5_154;44;25;8;33;11;75.00
linked-list1;test_3-5_0-5_171;44;25;5;30;14;68.18
linked-list1;test_3-5_0-0_16;44;25;8;33;11;75.00
linked-list1;test_3-5_1-0_317;44;25;11;36;8;81.82
linked-list1;test_3-5_0-1_36;44;25;8;33;11;75.00
linked-list1;test_3-5_0-5_175;44;25;5;30;14;68.18
linked-list1;test_3-5_0-8_242;44;25;9;34;10;77.27
linked-list1;test_3-5_0-0_23;44;25;8;33;11;75.00
linked-list1;test_3-5_0-8_254;44;25;8;33;11;75.00
linked-list1;test_3-5_0-6_207;44;28;5;33;11;75.00
linked-list1;test_3-5_0-9_287;44;32;9;41;3;93.18
linked-list1;test_3-5_0-8_264;44;38;2;40;4;90.91
linked-list1;test_3-5_0-0_3;44;25;8;33;11;75.00
linked-list1;test_3-5_0-2_87;44;25;8;33;11;75.00
linked-list1;test_3-5_0-7_230;44;25;8;33;11;75.00
linked-list1;test_3-5_0-0_22;44;25;8;33;11;75.00
linked-list1;test_3-5_0-8_249;44;25;8;33;11;75.00
linked-list1;test_3-5_0-7_212;44;25;8;33;11;75.00
linked-list1;test_3-5_0-9_299;44;28;5;33;11;75.00
linked-list1;test_3-5_0-7_217;44;34;6;40;4;90.91
linked-list1;test_3-5_0-0_20;44;25;8;33;11;75.00
linked-list1;test_3-5_0-2_86;44;25;8;33;11;75.00
linked-list1;test_3-5_0-3_108;44;25;8;33;11;75.00
linked-list1;test_3-5_0-3_112;44;25;5;30;14;68.18
linked-list1;test_3-5_1-0_305;44;33;2;35;9;79.55
linked-list1;test_3-5_0-3_107;44;25;5;30;14;68.18
linked-list1;test_3-5_0-6_193;44;25;8;33;11;75.00
linked-list1;test_3-5_0-5_167;44;25;8;33;11;75.00
linked-list1;test_3-5_0-2_81;44;25;8;33;11;75.00
linked-list1;test_3-5_0-0_8;44;25;8;33;11;75.00
linked-list1;test_3-5_0-4_125;44;25;8;33;11;75.00
linked-list1;test_3-5_1-0_307;44;25;11;36;8;81.82
linked-list1;test_3-5_0-1_54;44;25;8;33;11;75.00
linked-list1;test_3-5_0-5_152;44;25;8;33;11;75.00
linked-list1;test_3-5_0-3_94;44;25;8;33;11;75.00
linked-list1;test_3-5_0-3_103;44;25;8;33;11;75.00
linked-list1;test_3-5_0-7_215;44;33;1;34;10;77.27
linked-list1;test_3-5_1-0_309;44;26;8;34;10;77.27
linked-list1;test_3-5_0-6_199;44;26;8;34;10;77.27
linked-list1;test_3-5_0-3_110;44;25;8;33;11;75.00
linked-list1;test_3-5_0-8_266;44;25;8;33;11;75.00
linked-list1;test_3-5_0-1_49;44;25;8;33;11;75.00
linked-list1;test_3-5_0-3_106;44;25;8;33;11;75.00
linked-list1;test_3-5_0-2_82;44;25;8;33;11;75.00
linked-list1;test_3-5_0-7_216;44;28;1;29;15;65.91
linked-list1;test_3-5_0-2_73;44;25;11;36;8;81.82
linked-list1;test_3-5_0-6_204;44;28;6;34;10;77.27
linked-list1;test_3-5_0-3_99;44;25;8;33;11;75.00
linked-list1;test_3-5_0-1_31;44;25;8;33;11;75.00
linked-list1;test_3-5_0-3_100;44;25;5;30;14;68.18
linked-list1;test_3-5_0-1_40;44;25;8;33;11;75.00
linked-list1;test_3-5_0-8_258;44;25;7;32;12;72.73
linked-list1;test_3-5_0-0_28;44;25;8;33;11;75.00
linked-list1;test_3-5_0-6_195;44;25;8;33;11;75.00
linked-list1;test_3-5_0-4_126;44;25;9;34;10;77.27
linked-list1;test_3-5_0-1_33;44;25;9;34;10;77.27
linked-list1;test_3-5_0-6_202;44;26;8;34;10;77.27
linked-list1;test_3-5_0-0_25;44;25;8;33;11;75.00
linked-list1;test_3-5_0-1_53;44;25;8;33;11;75.00
linked-list1;test_3-5_0-0_9;44;25;8;33;11;75.00
linked-list1;test_3-5_0-0_1;44;25;8;33;11;75.00
linked-list1;test_3-5_0-3_113;44;25;5;30;14;68.18
linked-list1;test_3-5_0-0_29;44;25;8;33;11;75.00
linked-list1;test_3-5_0-1_42;44;25;8;33;11;75.00
linked-list1;test_3-5_0-2_62;44;25;8;33;11;75.00
linked-list1;test_3-5_0-9_271;44;28;4;32;12;72.73
linked-list1;test_3-5_0-0_14;44;25;8;33;11;75.00
linked-list1;test_3-5_0-0_11;44;25;8;33;11;75.00
linked-list1;test_3-5_0-1_37;44;25;8;33;11;75.00
linked-list1;test_3-5_0-0_7;44;25;8;33;11;75.00
linked-list1;test_3-5_0-9_290;44;36;5;41;3;93.18
linked-list1;test_3-5_0-1_43;44;25;8;33;11;75.00
linked-list1;test_3-5_0-1_44;44;25;8;33;11;75.00
linked-list1;test_3-5_0-4_135;44;25;8;33;11;75.00
linked-list1;test_3-5_0-9_298;44;28;5;33;11;75.00
linked-list1;test_3-5_0-2_76;44;25;8;33;11;75.00
linked-list1;test_3-5_1-0_304;44;28;5;33;11;75.00
linked-list1;test_3-5_0-8_244;44;28;1;29;15;65.91
linked-list1;test_3-5_0-5_164;44;25;11;36;8;81.82
linked-list1;test_3-5_0-7_221;44;25;8;33;11;75.00
linked-list1;test_3-5_0-4_122;44;25;5;30;14;68.18
linked-list1;test_3-5_0-1_41;44;25;9;34;10;77.27
linked-list1;test_3-5_0-4_136;44;25;8;33;11;75.00
linked-list1;test_3-5_1-0_313;44;32;9;41;3;93.18
linked-list1;test_3-5_0-3_117;44;25;11;36;8;81.82
linked-list1;test_3-5_0-2_80;44;25;8;33;11;75.00
linked-list1;test_3-5_0-4_140;44;25;9;34;10;77.27
linked-list1;test_3-5_0-0_12;44;25;8;33;11;75.00
linked-list1;test_3-5_0-3_93;44;25;8;33;11;75.00
linked-list1;test_3-5_0-0_18;44;25;8;33;11;75.00
linked-list1;test_3-5_0-0_26;44;25;8;33;11;75.00
linked-list1;test_3-5_0-1_60;44;25;5;30;14;68.18
linked-list1;test_3-5_0-1_58;44;25;8;33;11;75.00
linked-list1;test_3-5_0-3_97;44;25;8;33;11;75.00
linked-list1;test_3-5_0-0_30;44;25;8;33;11;75.00
linked-list1;test_3-5_0-2_89;44;25;8;33;11;75.00
linked-list1;test_3-5_0-9_289;44;31;9;40;4;90.91
linked-list1;test_3-5_0-5_173;44;28;5;33;11;75.00
linked-list1;test_3-5_0-7_237;44;25;5;30;14;68.18
linked-list1;test_3-5_0-1_52;44;25;8;33;11;75.00
linked-list1;test_3-5_0-1_51;44;25;8;33;11;75.00
linked-list1;test_3-5_0-1_32;44;25;9;34;10;77.27
linked-list1;test_3-5_0-2_68;44;25;8;33;11;75.00
linked-list1;test_3-5_0-0_13;44;25;8;33;11;75.00
linked-list1;test_3-5_0-1_47;44;25;8;33;11;75.00
linked-list1;test_3-5_0-1_39;44;25;8;33;11;75.00
linked-list1;test_3-5_0-2_63;44;25;8;33;11;75.00
linked-list1;test_3-5_0-0_27;44;25;8;33;11;75.00
linked-list1;test_3-5_0-7_240;44;32;9;41;3;93.18
linked-list1;test_3-5_0-0_6;44;25;8;33;11;75.00
linked-list1;test_3-5_0-1_59;44;25;8;33;11;75.00
linked-list1;test_3-5_0-9_282;44;25;8;33;11;75.00
linked-list1;test_3-5_0-4_129;44;25;9;34;10;77.27
linked-list1;test_3-5_0-6_189;44;38;2;40;4;90.91
linked-list1;test_3-5_0-1_57;44;25;8;33;11;75.00
linked-list1;test_3-5_0-1_34;44;25;8;33;11;75.00
linked-list1;test_3-5_0-5_162;44;25;9;34;10;77.27
linked-list1;test_3-5_0-1_55;44;25;8;33;11;75.00
linked-list1;test_3-5_0-5_166;44;25;8;33;11;75.00
linked-list1;test_3-5_0-2_65;44;25;8;33;11;75.00
linked-list1;test_3-5_0-4_149;44;25;8;33;11;75.00
linked-list1;test_3-5_0-5_156;44;25;5;30;14;68.18
linked-list1;test_3-5_0-6_194;44;25;8;33;11;75.00
linked-list1;test_3-5_0-2_74;44;25;8;33;11;75.00
linked-list1;test_3-5_0-2_69;44;25;8;33;11;75.00
linked-list1;test_3-5_0-2_84;44;25;9;34;10;77.27
linked-list1;test_3-5_0-9_295;44;25;11;36;8;81.82
linked-list1;test_3-5_0-2_85;44;25;8;33;11;75.00
linked-list1;test_3-5_0-0_19;44;25;8;33;11;75.00
linked-list1;test_3-5_0-2_79;44;25;5;30;14;68.18
linked-list1;test_3-5_0-0_15;44;25;8;33;11;75.00
linked-list1;test_3-5_0-0_21;44;25;8;33;11;75.00
linked-list1;test_3-5_0-8_245;44;28;6;34;10;77.27
linked-list1;test_3-5_0-8_255;44;28;5;33;11;75.00
linked-list1;test_3-5_0-7_234;44;25;8;33;11;75.00
linked-list1;test_3-5_0-0_24;44;25;8;33;11;75.00
linked-list1;test_3-5_0-8_246;44;25;8;33;11;75.00
linked-list1;test_3-5_0-0_2;44;25;8;33;11;75.00
linked-list1;test_3-5_0-3_119;44;25;8;33;11;75.00
linked-list1;test_3-5_0-1_38;44;25;8;33;11;75.00
linked-list1;test_3-5_1-0_303;44;36;5;41;3;93.18
linked-list1;test_3-5_0-6_209;44;25;5;30;14;68.18
